NO  textures/north.xpm
EA  textures/east.xpm
SO  textures/south.xpm
WE  textures/west.xpm
F   73,92,255
C   200,100,35

                11111111
                10001001
                10001001
                10000001
                10000011
                10000011
                10000011
111111111111111110000011
100000000000000000000001
100000000000000000000001
1000000111100011100000001111111
1000000000000011100000000000001
10000000000000000000N0000000001
1000000000000000000000000000001
1000000000000000000000000000001
1111111111111111111111100000001
                      100010001
                      100010001
                      100010001
                      111111111