NO  textures/north.xpm
EA  textures/east.xpm
SO  textures/south.xpm
WE  textures/west.xpm
F   2,72,210
C   200,25,52

            11111111
            10001001
            10001001
            10000001
            10000011
            10000011
            10000011
11111111111110000011
10000000000000000001
100000000000000000011
100001111000111000001111111
100000000011100000000000001
1000000000000000N0000000001
100000000000000000000000001
100000000000000000000000001
111111111111111111100000001
                   10010001
                   10010001
                   10010001
                   11111111