NO  textures/Grey_Bricks.xpm
EA  textures/Metalic.xpm
SO  textures/Vines.xpm
WE  textures/Rocky_Road.xpm
C   53,81,92
F   83,83,83

            11111111
            10001001
            10001001
            10000001
            10000011
            1000001
            10000011
1111111111111000001
10000000000000000001
100000000000000000011
100001111000111000001111111
100001  1001100000000000001
100001  10000000N0000000001
100001  1000000000000000001
100001  1000000000000000001
111111  1111111111110000001
                   10010001
                   10010001
                   10010001
                   10000001
                   11111111