NO  textures/north.xpm
EA  textures/east.xpm
SO  textures/south.xpm
WE  textures/west.xpm
F   0,0,210
C   200,0,2

1111111111
1000000001
1000000001
10000N0001
1000000001
1000000001
1111111111