NO  textures/north_bricks.xpm
EA  textures/east.xpm
SO  textures/south_bricks.xpm
WE  textures/west.xpm
F   0,0,210
C   200,0,2

11111
10001
10N01
10001
11111