EA  textures/Checkered.xpm
NO  textures/Red_Bricks.xpm
SO  textures/Grey_Bricks.xpm
WE  textures/Rocky_Road.xpm
C   53,150,150
F   83,83,83

111111111
100000001
100000001
100E00001
111111111
