NO  textures/Red_Bricks.xpm
EA  textures/Magma.xpm
SO  textures/Gray_Bricks.xpm
WE  textures/Rocky_Road.xpm
C   53,81,92
F   83,83,83

111111111
100000001
100000001
1000N0001
111111111