NO  textures/north.xpm
EA  textures/east.xpm
SO  textures/south.xpm
WE  textures/west.xpm
F   2,72,210
C   200,25,52

1111111111111111
1000000000000011
1000111111110011
100011    110011
1000111111110011
1000000N00000011
1000111111001111
100011  110011
10011  1100111111
110011  1100000011
111111  1111111111