NO 	textures/Water.xpm
SO  textures/Magma.xpm
EA  textures/Grass.xpm
WE  textures/Wood_Vertical.xpm
C	6,6,6
F   83,83,83

1111
1001
1E01
111