NO 	textures/Water.xpm
SO  textures/Magma.xpm
EA  textures/Grass.xpm
WE  textures/Wood_Vertical.xpm
C	255,23 ,255
F   83,83,83

1111111
1000001
1E00001
1000001
1111111