NO 	textures/Water.xpm
SO  textures/Magma.xpm
EA  textures/Grass.xpm
WE
C	55,100,35
F

1111111
1000001
1E00001
1000001
1111111