11111
10P01
10001
10001
10001
11111